,training set,tests,correct,incorrect,false positives,false negatives,correctness
0,82,8042,7890,152,152,0,98.10992290475006
1,163,7961,7831,130,130,0,98.36703931666877
2,244,7880,7794,86,86,0,98.90862944162437
3,325,7799,7729,70,70,0,99.10244903192716
4,407,7717,7695,22,22,0,99.71491512245692
5,488,7636,7628,8,0,8,99.8952331063384
6,569,7555,7539,16,16,0,99.78821972203839
7,650,7474,7458,16,16,0,99.78592453839978
8,732,7392,7388,4,0,4,99.94588744588745
9,813,7311,7307,4,0,4,99.94528792230885
10,894,7230,7226,4,0,4,99.94467496542185
11,975,7149,7145,4,0,4,99.94404811861799
12,1057,7067,7063,4,0,4,99.94339889627848
13,1138,6986,6982,4,0,4,99.94274262811336
14,1219,6905,6887,18,2,16,99.73931933381607
15,1300,6824,6820,4,0,4,99.94138335287222
16,1382,6742,6738,4,0,4,99.94067042420647
17,1463,6661,6657,4,0,4,99.93994895661312
18,1544,6580,6576,4,0,4,99.93920972644376
19,1625,6499,6495,4,0,4,99.93845206954916
20,1707,6417,6413,4,0,4,99.93766557581425
21,1788,6336,6332,4,0,4,99.93686868686869
22,1869,6255,6251,4,0,4,99.93605115907275
23,1950,6174,6170,4,0,4,99.93521218011014
24,2032,6092,6088,4,0,4,99.93434011818779
25,2113,6011,6007,4,0,4,99.93345533189154
26,2194,5930,5926,4,0,4,99.93254637436762
27,2275,5849,5845,4,0,4,99.93161224140879
28,2356,5768,5764,4,0,4,99.93065187239945
29,2438,5686,5682,4,0,4,99.92965177629264
30,2519,5605,5601,4,0,4,99.92863514719001
31,2600,5524,5520,4,0,4,99.9275887038378
32,2681,5443,5439,4,0,4,99.92651111519383
33,2763,5361,5357,4,0,4,99.92538705465398
34,2844,5280,5276,4,0,4,99.92424242424242
35,2925,5199,5195,4,0,4,99.92306212733217
36,3006,5118,5114,4,0,4,99.92184447049628
37,3088,5036,5032,4,0,4,99.92057188244638
38,3169,4955,4955,0,0,0,100.0
39,3250,4874,4874,0,0,0,100.0
40,3331,4793,4793,0,0,0,100.0
41,3413,4711,4711,0,0,0,100.0
42,3494,4630,4630,0,0,0,100.0
43,3575,4549,4549,0,0,0,100.0
44,3656,4468,4468,0,0,0,100.0
45,3738,4386,4386,0,0,0,100.0
46,3819,4305,4305,0,0,0,100.0
47,3900,4224,4224,0,0,0,100.0
48,3981,4143,4143,0,0,0,100.0
49,4063,4061,4061,0,0,0,100.0
50,4144,3980,3980,0,0,0,100.0
51,4225,3899,3899,0,0,0,100.0
52,4306,3818,3818,0,0,0,100.0
53,4387,3737,3737,0,0,0,100.0
54,4469,3655,3655,0,0,0,100.0
55,4550,3574,3574,0,0,0,100.0
56,4631,3493,3493,0,0,0,100.0
57,4712,3412,3412,0,0,0,100.0
58,4794,3330,3330,0,0,0,100.0
59,4875,3249,3249,0,0,0,100.0
60,4956,3168,3168,0,0,0,100.0
61,5037,3087,3087,0,0,0,100.0
62,5119,3005,3005,0,0,0,100.0
63,5200,2924,2924,0,0,0,100.0
64,5281,2843,2843,0,0,0,100.0
65,5362,2762,2762,0,0,0,100.0
66,5444,2680,2680,0,0,0,100.0
67,5525,2599,2599,0,0,0,100.0
68,5606,2518,2518,0,0,0,100.0
69,5687,2437,2437,0,0,0,100.0
70,5769,2355,2355,0,0,0,100.0
71,5850,2274,2274,0,0,0,100.0
72,5931,2193,2193,0,0,0,100.0
73,6012,2112,2112,0,0,0,100.0
74,6094,2030,2030,0,0,0,100.0
75,6175,1949,1949,0,0,0,100.0
76,6256,1868,1868,0,0,0,100.0
77,6337,1787,1787,0,0,0,100.0
78,6418,1706,1706,0,0,0,100.0
79,6500,1624,1624,0,0,0,100.0
80,6581,1543,1543,0,0,0,100.0
81,6662,1462,1462,0,0,0,100.0
82,6743,1381,1381,0,0,0,100.0
83,6825,1299,1299,0,0,0,100.0
84,6906,1218,1218,0,0,0,100.0
85,6987,1137,1137,0,0,0,100.0
86,7068,1056,1056,0,0,0,100.0
87,7150,974,974,0,0,0,100.0
88,7231,893,893,0,0,0,100.0
89,7312,812,812,0,0,0,100.0
