,training set,tests,correct,incorrect,false positives,false negatives,correctness
0,82,8042,7962,80,80,0,99.0052225814474
1,163,7961,7881,80,80,0,98.99510111795
2,244,7880,7824,56,48,8,99.28934010152284
3,325,7799,7743,56,48,8,99.28195922554174
4,407,7717,7697,20,12,8,99.74083192950629
5,488,7636,7592,44,4,40,99.42378208486119
6,569,7555,7523,32,0,32,99.57643944407677
7,650,7474,7442,32,0,32,99.57184907679957
8,732,7392,7352,40,16,24,99.45887445887446
9,813,7311,7287,24,0,24,99.6717275338531
10,894,7230,7206,24,0,24,99.66804979253112
11,975,7149,7143,6,6,0,99.91607217792698
12,1057,7067,7061,6,6,0,99.91509834441771
13,1138,6986,6980,6,6,0,99.91411394217006
14,1219,6905,6899,6,6,0,99.91310644460536
15,1300,6824,6812,12,0,12,99.82415005861665
16,1382,6742,6738,4,4,0,99.94067042420647
17,1463,6661,6657,4,4,0,99.93994895661312
18,1544,6580,6576,4,4,0,99.93920972644376
19,1625,6499,6495,4,4,0,99.93845206954916
20,1707,6417,6413,4,4,0,99.93766557581425
21,1788,6336,6332,4,4,0,99.93686868686869
22,1869,6255,6251,4,4,0,99.93605115907275
23,1950,6174,6170,4,4,0,99.93521218011014
24,2032,6092,6088,4,4,0,99.93434011818779
25,2113,6011,6007,4,4,0,99.93345533189154
26,2194,5930,5926,4,4,0,99.93254637436762
27,2275,5849,5845,4,4,0,99.93161224140879
28,2356,5768,5764,4,4,0,99.93065187239945
29,2438,5686,5682,4,4,0,99.92965177629264
30,2519,5605,5601,4,4,0,99.92863514719001
31,2600,5524,5520,4,4,0,99.9275887038378
32,2681,5443,5439,4,4,0,99.92651111519383
33,2763,5361,5361,0,0,0,100.0
34,2844,5280,5280,0,0,0,100.0
35,2925,5199,5199,0,0,0,100.0
36,3006,5118,5118,0,0,0,100.0
37,3088,5036,5036,0,0,0,100.0
38,3169,4955,4955,0,0,0,100.0
39,3250,4874,4874,0,0,0,100.0
40,3331,4793,4793,0,0,0,100.0
41,3413,4711,4711,0,0,0,100.0
42,3494,4630,4630,0,0,0,100.0
43,3575,4549,4549,0,0,0,100.0
44,3656,4468,4468,0,0,0,100.0
45,3738,4386,4386,0,0,0,100.0
46,3819,4305,4305,0,0,0,100.0
47,3900,4224,4224,0,0,0,100.0
48,3981,4143,4143,0,0,0,100.0
49,4063,4061,4061,0,0,0,100.0
50,4144,3980,3980,0,0,0,100.0
51,4225,3899,3899,0,0,0,100.0
52,4306,3818,3818,0,0,0,100.0
53,4387,3737,3737,0,0,0,100.0
54,4469,3655,3655,0,0,0,100.0
55,4550,3574,3574,0,0,0,100.0
56,4631,3493,3493,0,0,0,100.0
57,4712,3412,3412,0,0,0,100.0
58,4794,3330,3330,0,0,0,100.0
59,4875,3249,3249,0,0,0,100.0
60,4956,3168,3168,0,0,0,100.0
61,5037,3087,3087,0,0,0,100.0
62,5119,3005,3005,0,0,0,100.0
63,5200,2924,2924,0,0,0,100.0
64,5281,2843,2843,0,0,0,100.0
65,5362,2762,2762,0,0,0,100.0
66,5444,2680,2680,0,0,0,100.0
67,5525,2599,2599,0,0,0,100.0
68,5606,2518,2518,0,0,0,100.0
69,5687,2437,2437,0,0,0,100.0
70,5769,2355,2355,0,0,0,100.0
71,5850,2274,2274,0,0,0,100.0
72,5931,2193,2193,0,0,0,100.0
73,6012,2112,2112,0,0,0,100.0
74,6094,2030,2030,0,0,0,100.0
75,6175,1949,1949,0,0,0,100.0
76,6256,1868,1868,0,0,0,100.0
77,6337,1787,1787,0,0,0,100.0
78,6418,1706,1706,0,0,0,100.0
79,6500,1624,1624,0,0,0,100.0
80,6581,1543,1543,0,0,0,100.0
81,6662,1462,1462,0,0,0,100.0
82,6743,1381,1381,0,0,0,100.0
83,6825,1299,1299,0,0,0,100.0
84,6906,1218,1218,0,0,0,100.0
85,6987,1137,1137,0,0,0,100.0
86,7068,1056,1056,0,0,0,100.0
87,7150,974,974,0,0,0,100.0
88,7231,893,893,0,0,0,100.0
89,7312,812,812,0,0,0,100.0
